   ####             
####@ #             
#   $ #             
# $...##            
##$ *. #            
 #  $  #            
 #  ####            
 ####               
   ####             
####@ #             
#     #             
# $.*.##            
##$ *. #            
 #  $  #            
 #  ####            
 ####               
   ####             
####@ #             
#     #             
# $.*.##            
##$ *. #            
 #   $ #            
 #  ####            
 ####               
   ####             
####@ #             
#     #             
#  **.##            
##$ *. #            
 #   $ #            
 #  ####            
 ####               
   ####             
####@ #             
#     #             
#  **.##            
##$$.. #            
 #   $ #            
 #  ####            
 ####               
   ####             
####@ #             
#     #             
# $**.##            
## $.. #            
 #   $ #            
 #  ####            
 ####               
   ####             
####@ #             
# $   #             
#  **.##            
## $.. #            
 #   $ #            
 #  ####            
 ####               
   ####             
####@ #             
#  $  #             
#  **.##            
## $.. #            
 #   $ #            
 #  ####            
 ####               
   ####             
####@ #             
#   $ #             
#  **.##            
## $.. #            
 #   $ #            
 #  ####            
 ####               
   ####             
####@ #             
#    $#             
#  **.##            
## $.. #            
 #   $ #            
 #  ####            
 ####               
   ####             
####@ #             
#    $#             
#  *..##            
## $*. #            
 #   $ #            
 #  ####            
 ####               
   ####             
####@ #             
#    $#             
#  *..##            
## $*. #            
 #  $  #            
 #  ####            
 ####               
   ####             
####@ #             
#    $#             
#  *..##            
## $*. #            
 # $   #            
 #  ####            
 ####               
   ####             
####@ #             
#    $#             
#  *..##            
## $*. #            
 #$    #            
 #  ####            
 ####               
   ####             
####@ #             
#    $#             
#  *..##            
##$$*. #            
 #     #            
 #  ####            
 ####               
   ####             
####@ #             
#    $#             
# $*..##            
## $*. #            
 #     #            
 #  ####            
 ####               
   ####             
####@ #             
# $  $#             
#  *..##            
## $*. #            
 #     #            
 #  ####            
 ####               
   ####             
####@ #             
# $  $#             
#  .*.##            
## $*. #            
 #     #            
 #  ####            
 ####               
   ####             
####@ #             
# $   #             
#  .**##            
## $*. #            
 #     #            
 #  ####            
 ####               
   ####             
####@ #             
# $   #             
#  .*.##            
## $** #            
 #     #            
 #  ####            
 ####               
   ####             
####  #             
#@ $  #             
#  .*.##            
## $** #            
 #     #            
 #  ####            
 ####               
   ####             
####  #             
#@  $ #             
#  .*.##            
## $** #            
 #     #            
 #  ####            
 ####               
   ####             
####@ #             
#    $#             
#  .*.##            
## $** #            
 #     #            
 #  ####            
 ####               
   ####             
####@ #             
#     #             
#  .**##            
## $** #            
 #     #            
 #  ####            
 ####               
   ####             
####  #             
#     #             
#  ***##            
## @** #            
 #     #            
 #  ####            
 ####               
