7
########
#   .  #
# $ #  ##
# ** ** #
##  # $ #
 #  . @ #
 ########
