7
#######
#. #  #
#  $  #
#. $#@#
#  $  #
#. #  #
#######
