9
 ####
 #  #####
 #$   $ #
 # .#.  #
## ### ##
# $.#. #
# @   $#
#####  #
    ####
