7
#####
#   ####
# # .  #
# #$.  #
# @$*# #
####   #
   #####
