8
 ######
 #@   #
 #  $ #
 # #$##
## . #
#  .$#
#  . #
######
