8
   #### 
#### @#
#   $ #
# $...##
##$ *. #
 #  $  #
 #  ####
 ####